1 1 1 1 1 7 2 2 2 2 7 1 1 1 1 1
1 5 0 0 0 0 0 0 0 0 3 0 0 8 0 1
1 0 0 3 0 0 8 0 3 0 0 0 3 0 0 1
1 0 3 0 3 0 0 4 0 0 8 0 0 8 0 6
1 0 0 3 8 0 3 0 0 3 0 0 3 0 0 1
1 0 8 0 3 0 8 0 8 0 8 0 0 8 0 1
1 0 3 0 0 3 0 5 3 0 4 3 0 8 0 1
1 3 0 3 0 0 3 0 3 8 0 4 0 0 0 1
1 0 8 0 3 4 0 8 0 3 0 0 0 3 0 6
1 3 0 4 0 0 0 0 3 0 8 0 3 0 8 1
1 5 8 0 0 0 0 3 0 0 0 4 8 0 5 1
1 1 1 1 1 7 2 2 2 2 7 1 1 1 1 1
